NO ./textures/north.xpm
WE ./textures/west.xpm
SO ./textures/south.xpm
EA ./textures/east.xpm
 
F 29,29,29
C 48,48,48
 
          111111111111111111111111
         1100000000000011100000001
        111000000001000000001D1001
1111111111111111110111111111101111
110000000000000001D100000000000001
1000001110001110000100011111100001
10000111100110110001000D0000100001
1000110110000011000111111110111111
1000111111011110000110000000000011
1000000110011000000111111111110111
100000011001111100010000000001D101
110000000000000000110E000000000001
1111111111111111111111111111111111